1 37x41 \
    RTOP=16.5 \
  RGHOST=20.5 CGHOST=18.5 ROGHOST=2 COGHOST=2.5 \
  RFRUIT=23.5 CFRUIT=18.5 \
   RHERO=31.5  CHERO=18.5 \
    RMSG=23     CMSG=13 \
   RMSG2=15    CMSG2=13 \
   READY="   READY!  " \
 PLAYER1="PLAYER ONE " \
 PLAYER2="PLAYER TWO " \
GAMEOVER=" GAME OVER." \
   ABOUT="Inspired by Toru Iwatani/Namco's Pac-Man/Puckman"
╔════════════════╕─╒════════════════╗
║················│ │················║
║·┌────┐·┌─────┐·│ │·┌─────┐·┌────┐·║
║·│    │·│     │·│ │·│     │·│    │·║
║■│    │·│     │·│ │·│     │·│    │■║
║·│    │·│     │·│ │·│     │·│    │·║
║·└────┘·└─────┘·└─┘·└─────┘·└────┘·║
║···································║
║·┌────┐·┌─┐·┌─────────┐·┌─┐·┌────┐·║
║·│    │·│ │·│         │·│ │·│    │·║
║·└────┘·│ │·└───┐ ┌───┘·│ │·└────┘·║
║········│ │·····│ │·····│ │········║
╚══════╗·│ └───┐ │ │ ┌───┘ │·╔══════╝
       ║·│     │ │ │ │     │·║       
       ║·│ ┌───┘ └─┘ └───┐ │·║       
       ║·│ │             │ │·║       
       ║·│ │ ╔════≡════╗ │ │·║       
       ║·│ │ ║         ║ │ │·║       
═══════╝·└─┘ ║         ║ └─┘·╚═══════
        ·    ║         ║    ·        
═══════╗·┌─┐ ║         ║ ┌─┐·╔═══════
       ║·│ │ ║         ║ │ │·║       
       ║·│ │ ╚═════════╝ │ │·║       
       ║·│ │             │ │·║       
       ║·│ │ ┌─────────┐ │ │·║       
       ║·│ │ │         │ │ │·║       
╔══════╝·└─┘ └───┐ ┌───┘ └─┘·╚══════╗
║················│ │················║
║·┌────┐·┌─────┐·│ │·┌─────┐·┌────┐·║
║·│    │·│     │·│ │·│     │·│    │·║
║·└──┐ │·└─────┘·└─┘·└─────┘·│ ┌──┘·║
║■···│ │·········· ··········│ │···■║
╙──┐·│ │·┌─┐·┌─────────┐·┌─┐·│ │·┌──╜
│  │·│ │·│ │·│         │·│ │·│ │·│  │
╓──┘·└─┘·│ │·└───┐ ┌───┘·│ │·└─┘·└──╖
║········│ │·····│ │·····│ │········║
║·┌──────┘ └───┐·│ │·┌───┘ └──────┐·║
║·│            │·│ │·│            │·║
║·└────────────┘·└─┘·└────────────┘·║
║···································║
╚═══════════════════════════════════╝
